1111111111111111111111111111111
10000000000E0000000000000000001
1000000000000000000000000000001
10000000C00000000C0000000000001
1000000000000000000000000000001
100000000P000000000000000000001
1000000000000000000000000000001
1000000000000000C00000000000001
1000000000000000000000000000001
1000000000000000000000000000001
1111111111111111111111111111111